##########
#?   #####
#### #####
####  ####
##### ####
###   ####
### ######
### ######
###   $###
##########
