#########################################################################
#?                                              #########################
# ##### ###### ################## #######################################
# ##### ###### ################## #######################################
# #####        ################## #######################################
# ##### #######    ############## #######################################
# ##### ########## ############## ######                                #
# ##### ########## ############## ########### ########################  #
#                                  ########## ######################### #
# ################ ##############  ########## ######################### #
# ################ ##############  ########## ######################### #
# ####### ######## ##############  ########## ######################### #
# ##$     ######## ##############  ########## ######################### #
# ### ###          ##############                         ############# #
# ### ############ ##############  ################# ################## #
# ### ############ ################################# ################## #
# ###    ######### ################################# ################## #
# ###    #########                                                      #
# ###    ######### ##################### ########### ####################
# ###    ######### ##################### ########### ####################
# ###    ######### ##################### ########### ####################
#                                                    ####################
#########################################################################
